This is scriptcraft map version 1.
^ ^ ^ ^ ^ ^ ^ ^ ^ ^ ^ ^ ^ ^ ^ ^ ^ ^ ^ ^ ^ ^ ^ ^ ^ ^ ^ ^M^ ^ ^ ^ ^M^ ^ ^ ^ ^ ^M^ ^ ^ ^ ^ ^ ^ ^ ^ ^ ^ ^ ^ ^ ^ ^ ^ ^ ^ ^ ^ ^ ^ ^ ^ 
^ ^ ^ ^ ^ ^ ; ; ^ ^ ^ ; ; ; ; ;T;T; ;T; ; ; ; ; ;S; ; ; ; ^M^ ^ ^ ^ ^ ;S; ; ; ; ; ; ; ; ; ;T; ; ;T; ; ; ; ^ ^ ^ ^ ^ ^ ^ ^ ^ ^ ^ 
^ ^ ^ ^ ^ ^ ; ; ; ; ; ; ; ; ; ; ;T; ;T; ; ; ; ; ; ; ; ; _ _ _ ^ ^ ^ ^ ; ; ; ; ; ; ; ; ; ;T; ; ;T;T; ; ; ; ; ^ ^ ^ ^ ^ ^ ^ ^ ^ ^ 
^ ^ ^ ; ; ; ; ; ; . . ; ; ; ; ; ;T;T; ;T; ; ;T; ; ; ; _ _ _ _M_ _ _ ^ ; ; ; ;M; ; ; ; ; ; ; ;T; ; ; ; ; ; ; . ^ ^ ^ _M_ _M_ ^ ^ 
^ ^ ; ; ; ; . .T.T. . ;S; ; ; ; ; ;T;T; ;T; ; ; ; ; _ _ _ _M^ _ _ _ ^ _M; ; ; ;T;T; ; ;T; ;T; ;T; ; ; ; ; ; ; ; ^ ^ _ _ _ _ ^ ^ 
^ ^ ; ; ; .T.T. . . . ; ; ; ; ; ; ;T; ;T;T; ; ; ;M_ _ _ _M^ ^ ^ ^ ^ ^M^ _ ; ; ;T;T; ; ; ;T;T; ; ; ; ; . . . ; ;S^ ^ ^ _ _M_ ^ ^ 
^ ^ ; ; ; .T.T. _M_ ; ; ; ; ; ; ; ; ;T; ;T; ; ; ; _ _ _M^ ^ ; ; ; ^ ^ _ ^ ; ; ; ; ; ;T; ; ;T;T; ; ; ; . . ; ; ; ; ; ^ _ _M_ ^ ^ 
^ ; ; ; _ _ . . _M_ _ _ _ _M; ; ; ; ; ;T;T; ; ; ; ; ; ; ^ ^ ; ;S; ^ ^ ^ ; ; ; ; ; ; ;T; ;T;T; ; ; ; ; . ; _ _ ; ; ; ^ _ _ _ ^ ^ 
^ ; ; _ _M_ _ _M_ _ _ _M_ _ ; ; ; ; ; ;T;T;T; ; ; ; ; ; ^ ^ ; ; ; ^ ^ ; ; ; ; ; ; ;T; ; ;T; ;T; ; ; ; . _M_ _M_ _ ; ; ; ; ; ^ ^ 
^ ; ; _ ; ; ; _M_ _ _ _ _ _ _M; ;T; ; ; ;T;T;T; ; ; ; ^ ^ ^ ^ ^ ^ ^ ; ; ; ; ; ; ; ;T; ;T; ;T; ; ; ; ; ; ; _M_ _M; ; ; ; ; ; ^ ^ 
^ ; _M_ ; ; ; ; ; ; ; ; _ ; ; ; ; ; ; ; ;T;T;T; ; ; ; ; ^ ^ ^ . ; ; ; ; ; ; ; ; ; ; ;T;T;T;T; ; ; ; ; ; ; ; _ _ _ ; ; ; ;S; ^ ^ 
^ ; _ _ ; ; ; ; ; ; ;S; _ _ ; ; ; ; ; ; ; ;T;T;T; ; ;T; ; ; ; . ; ; ; ;T;T; ; ;T;T;T;T; ; ; ; ; ; ; ;S; ; ; _ _ _ ; ; ; ; ; ^ ^ 
^ ; ; _ .S. . ; ; ; ; ; ; _ _M; ; ; ;T; ; ; ;T; ;T; ; ; ; ; ; . ; ; ; ^ ^ ; ;T; ; ; ; ;T; ; ; ; ; ; ; ; ; ; _ _ _ _M; ; ; ; ^ ^ 
^ ; ; . . . . ;M; ;T; ; ; _M; . ; ; ; ; ; ;T; ;T;T;T; ; ; ; ; . ; ; ;T^ ^ ; ; ;T;T;T;T; ; ; ; ; ; . . ; ; ; _M_ _M; ; ; ; ; ^ ^ 
^ ; ; ; ; ; ; ; ; ; ;T; ; ; ; . ; ; ; ; ; ;T;T;T; ;T; ; ; ; . . ; ; ; ;T; ;T; ;T; ; ; ; ; ;T; ; . . ; ; ; . _ ; . . . .T. . ^ ^ 
^ ^ ; ; ; ; ; ; ; ; ; ;T; ; ; . . ; ; ; ; ; ; ; ;T;T; ; ; ; . ; ; ; ;T; ;T; ;T;T;T; ; ; ; ; . . . ; ; ; .M; ; ; . .T.T. .T. . ^ 
^ ^ ; ; ;T; ; ;T; ; ; ; ; ; ; ; . . ; ;T; ; ; ; ;T; ;T; ; ; . ; ; ; ;T; ; ;T;T; ; ; ;T;T; . . ; ; ; ; ; ; ; ; ; ; . . . . . .T^ 
^ ; ; ; ; ;T; ; ; ; ;T; ; ; ; ; ; . . . . ; ; ; ; ; ; ; ; ; . . . ; ;T; ;T;T; ; ; ; ; ; . . ; ; ; ; ; ; ; ; ; ; ; ; .T. . ;T; ^ 
^ ;T;T;T;T; ;T; ; ;T; ; ;T; ; ; ; ; ; ; . . ; ; ; ;T; ; ; ; ; ; . ; ;T;T;T; ; ; ; ; ;T. . ; ; ; ; ; ; ;T; ;T; ; ;T; ;T; ; ;T;T^ 
^ ;T;T;T; ;T; ;T;T;T;T;T;T; ; ;T; ; ; ; ; . . ; ; ; ; ; ; ; ; . . ; ; ; ; ; ; ; ; ; . . ; ; ; ; ; ; ; ;T;T; ;T;T; ;T; ;T;T;T;T^ 
^ ; ; ;T;T;T;T;T; ; ;T;T; ;T;T; ; ;T; ; ; ; . . ; ; ; ; ;T; ; . . ; ; ; ; ; ; ; ; . . ; ; ; ; ;T;T;T;T; ;T;T; ;T;T;T; ; ;T;T;T^ 
^ ; ; ; ;T;T;T;T;T;T;T; ;T; ; ;T; ;T; ; ; ; ; . . ; ; ; ; ; ; . ; ; ; ; ; ; ; ; . . ; ; ; ;T; ;T; ; ;T;T;T; ; ; ; ; ; ;T; ; ; ^ 
^ ; ;T;T; ; ;T; ; ; ; ; ; ;T;T;T;T; ;T; ;T; ; ; . . ; ; ; ; . . ; ; ; ; ; ; ; . . ; ; ; ;T; ;T; ; ; ; ;T; ; ;T; ; ; ; ; ; ; ;T^ 
^ ; ; ; ; ;T; ;T; ;T; ;T; ; ; ;T;T;T;T;T; ; ; ; ; . . ; ; ; . . ; ; ;T; ; . . ; ; ; ; ;T;T;T;T; ; ;T; ; ; ;T; ; ; ; ; _ _ _M_ ^ 
^ ; ; ; ; ; ; ; ; ; ; ; ; ; ; ; ; ;T; ; ;T;T; ; ; ; . .M; ; . . ; ;T;T; ; . . ; ; ; ; ;T; ;T; ; ;T; ; ; ; ; ; ; ; ; _ _ _ _ _M^ 
^ ; ;S; ; ; ; ; ; ; ; ; ; ; ; ; ;T; ;T;T;T; ; ; ; ; ; . ;M; . . ;M; ; ; . . ; ; ; ; ; ;T;T; ; ;T; ; ; ; ; ; ; ; ; _ _ _ _ _ _ ^ 
^ ; ; ; ; ; ; ; ; ; ; ; ; ; ; ; ; ; ; ; ;T; ; ; ; ; ; . . ; ; . ;M; ; . . ; ; ; ; ;T; ; ; ;T;T; ; ; ;T; ; ; ; ; _ _ _ _S_ _ _ ^ 
^ ; ; ; ; ; ; ; ; ;M; ; ; ; ; ; ; ; ; ; ; ;T; ; ; ; ; ; _ . ; . ; ; . . ; ; ; ; ;T; ; ; ; ; ; ; ; ; ;T; ; ; _M_M_ _ ^ ^ ^ ^ ^ ^ 
^ ; ; ; _M; ; ; ; ; ; ; ; ; ; ; ; ; ; ; ; ; ; ; ; ; _ _ _M_ ; .M; . . _M_ ; ; ; ; ; ; ; ; ; ; ; ; ; ; ; ; _M_ _ _ _ ^ ^ ^ ^ _M^ 
^ _M_ _M_ ; ; ; ; ; ; ; ; ; ; ; ; ; ; ; ; ; ; ; ; ; _ _M_ _ @ @ @ . _ _M_ ; ; ; ; ; ; . . ; ; ;T; ; ; ; ; _ _ _ _ _ ^ ^ ^ _ _ ^ 
^M_ _ _M_ ; ; ; ;S; ; ; . . . . ; ; ; ; ; ; ; . . . _ _ ; @ @ @ @ @ _ _ _ . . . . . . . . . ; ; ; ; ; ; ; _ _ _ _ _ ^ ^ _M_ _M^ 
^M_ _ _ _ ; ; ; ; ; ; . . ; ; . . . ; ; ;T. . . ; . . . .M@ @ @S@ @ .M. . . . . ; ; ; ; ; . . . . . . . . ; ; ; ^ ^ ^ ^M_ _ _ ^ 
^ ^ ^ ^ _M_ _ ; ; ; ; ; ; ; ; ; ; . . . . . ; ; ; _ _M_ ; @ @ @ @ @ _ _ _ _ ; ; ; ; ; ;T; ; ; ; ; ; ; ; ; ; ;S; ^ ^ ^M^ _ _M_ ^ 
^ ^ ^ ^ _ _M_ ; ; ; ; ; ; ; ; ; ; ; ; ; ; ; ; ; ; _ _ _ . . @ @ @ . . _ _M_ ;T; ; ; ; ; ; ; ; ; ; ; ; ; ; ; ; ; ; ^ ^ ^ ^ ^ ^M^ 
^ ^ ^ ^ ^ . . . . . ; ; ; ; ; ; ; ; ; ; ; ; ; ; ; _M_ . . _ _ .M; ; . .M_ _ ; ; ; ; ;T; ; ;T; ; ; ; ; ; ; . . . ; ; ^ ^S^ ^ ^ ^ 
^ ^S^ ^ ^ . .M. . . ; ; ; ; ; ; ; ; ; ; ; ; ; ; ; ; . . _M_ _ . ;T_ _ . . ; ; ; ; ; ;T;T;T; ;T;T; ; ; ; . .T.T. ; ; ; ^ ^ ^ ^ ^ 
^ ^ ^ ^ . . . . .M; ; ; ; ; ; ;T; ; ; ; ;T; ; ; ; ; . ; _ _M; . ;T_M_M; . . ; ; ; ; ; ;T;T;T; ; ;T; ; ; . . . . . ; ; ; ; ^ ^ ^ 
^ ^ ^ ^ . . . . ; ; ; ; ; ; ; ; ; ; ; ;T;T; ; ; ; . . ; ; ; ; . ; ; ; ; ; . . . . . ; ; ; ; ;T;T; ;T; ;T;T; ;T; ; ; ; ; ; ^ ^ ^ 
^M^ ^ . . . . . ; ; ;T; ; ;T;T;T;T; ;T; ; ; ; ; . . ; ; ; ; ; . . ; ; ; ; ; ; ; ; . . ; ; ; ; ;T; ;T; ;T; ; ; ; ;T; ;T; ; ; ^ ^ 
^ ^ ^ . . . ; ; ; ; ; ; ;T. . . ; ;T; ; ; ; ; ; . ; ; ; ; ; ; ; . ; ; ; ; ; ; ; ; ; . . ; ; ; ; ;T;T;T;T;T; ;T; ; ; ; ; ;T; ; ^ 
^ ^ . . .T; ; ;T; ; ; ;T;T. . . ;T; ; ; ; ; ; ; . ; ; ;T; ; ; ; . ; ;T; ; ; ; ; ; ; ; . . ; ; ; ; ;T;T;T;T;T; ;T; ;T; ;T; ; ;T^ 
^ ^ ;T; ; ; ; ; ;T; ;T;T; . . ;T; ; ; ; ; ; ; . . ; ; ; ; ; ; . . ; ; ;T; ; ; ; ; ; ; ; . . ; ; ; ; ; ; ; ;T; ; ;T;T; ;T; ;T; ^ 
^ ;T; ;T; ; ;T;T; ;T; ;T;T;T;T; ; ; ; ; . . . . ; ; ; ;T; ; ; . ; ; ; ; ; ;T; ; ; ; ; ; ; . . ; ; ; ; ;T;T;T;T; ; ; ; ;T;T;T;T^ 
^ ; ;T; ;T;T;T; ; ;T; ; ; ;T; ; ; ; ; . . ; ; ; ; ; ;T;T;T; . . ; ; ;T; ;T; ;T;T; ; ; ; ; ; . . . . . ; ; ; ; ;T;T;T;T;T;T;T;T^ 
^ ; ; ; ;T;T; ;T;T; ; ;T; ; ; ; ; ; . . ; ; ; ; ; ;T;T; ;T; . ; ; ; ; ;T; ;T;T;T; ; ; ; ; ; ; ; ; ; . ; ; ;T;T; ; ; ;T;T;T;T;T^ 
^ ;T;T;T;T; ;T; ; ; ; ; ; ; ; ; ; . . ; ; ; ;T; ;T; ; ;T; ; . ; ; ; ; ; ; ; ;T;T; ; ; ; ; ; ; ; ; ; . ; ; ; ; ; ; ; ; ; ; ;T;T^ 
^ . . . . ; ; ; ; ; ; ; ; ; ; ; . . ; ; ; ; ; ;T; ; ;T; ; ; ; . ; ; ; ; ;T; ;T; ;T; ; ; ; ; ; ; ; ; . . . ; ; ; ; ; ; ; ; ; ^ ^ 
^ ^ ^ . . .S; ; ; . .M; ; ; ; . . ; ;T; ; ; ; ;T; ;T; ; ; ; ; . . ; ; ; ; ; ;T;T;T;T;T; ; ; ; ;T; ; ; ; . ; ; ; ; ; ;S; ; ^ ^ ^ 
^ ^ ^ . . . ; ; ; .M. ; ; ; . . ; ; ; ; ; ; ;T;T; ; ; ; ; ; ; . .T;T; ; ; ;T; ;T; ; ; ;T; ; ; ; ; ; ; ; ;M; ; ; ; ; ; ; ^ ^ ^M^ 
^ ^ . . . _ _ ; ; ; ; ; ; ; . ; ; ;T; ; ;T;T;T; ;T; ; ; ; ; ; . . ; ; ; ; ; ; ;T;T;T;T; ; ; ;T; ; ; ; ; ; ; ; ; ; ; ; ; ^ ^ ^ ^ 
^ ^ . _M_ _ _ _ _M; ; ; ;S; ; ; ; ; ; ;T;T; ;T; ; ;T; ; ; ; . . ; ; ; ; ; ; ;T; ;T; ;T;T; ; ; ; ; ; ; ; ; ; ; _M_ ; ; ; ^ ^ ^ ^ 
^ ^ . _ _ _ _M; ; ; ; ; ; ; ; ; ;T; ; ;T; ;T; ; ; ; ; ; ; ; . . ; ; ; ;T; ; ; ; ;T;T;T; ;T; ; ; ; ; ;S; ; ; ; _ _M_ ; ; _M_ _ ^ 
^ ^ . _M_ _ _M; ; ; ; ; ; ; ; ; ;T; ; ;T;T; ; ; ; ;T; ; ; ; . . ; ; ; ; ;T; ; ; ; ;T;T; ;T; ; ; ; ; ; ; ; ; ; _M_ _M_ _ _ _ _ ^ 
^ . . . _ _ _ ; ; ; ; ; ; ; ; ; ; ; ; ;T;T; ; ;T; ; ; ; ; ; ; ; ; ; ; ;T; ; ; ; ; ;T;T;T; ; ; ; ;T; ; ; ; ; ; _ _ _ _ _ _M_ _ ^ 
^ . . . _M_ _ ; ; ; ;M_ _ _ ; ; ; ; ;T;T; ;T; ; ; ; ; ; ; ; ; ;S; ; ; ; ; ; ; ;T; ; ;T;T; ;T; ; ; ; ; ;M; ; ; ; ; ; _ _ _ _M_ ^ 
^ . . . . _ _M_ _ _ _ _M;M_ ; ; ; ;T;T; ;T; ; ; ; ; ; ; ; ; ; ; ; ; ; ; ; ; ; ; ; ; ;T;T;T; ; ; ; ; ; ; ; ; ; ; ; ; _ _ _ _ _ ^ 
^ . . . . . . _ _ _ _ _ _ _ ; ; ;T;T; ;T; . .T. ; ; ; _M_ _ ; ; ; ; ; ; ; ; ; ; ; ; ; ; ;T;T; ;T; ; ; ; ; ; ; ; ; ; _ _M_ _ _ ^ 
^ . . . . ; ; ; ; ; ; _ _ ; ; ; ;T; ;T; . . . . . ; ; _ _M_ ; ; ; ;M; ; ; ;M; ; ; ; ; ; ; ;T;T; ; ;T;T; ; ; ;S; ; ; _M_ _ _ _ ^ 
^ ^ . . . ; ; ; ;S; ; ; ; ;T; ;T;T; ;T. . .T. .T. . ; ; _ _ _ _M; ; ; ; ; ; ; ; ; ; ;T; ; ; ; ;T; ; ; ; ;T; ; ; ; ; _ _ _ . . ^ 
^ ^ ^T;T;T;T;T; ; ; ; ;T; ; ; ;T; ;T; . . .T.T.T. . ; ; _ _ _M_M_ _ ; ; ; ; ; ; ; ; ; ; ; ;T; ; ;T;T;T;T; ; ;T; . . . . . ^ ^ ^ 
^ ^ ^ ^ ^T;T; ;T; ;T; ; ;T; ;T;T;T;T; .T.T. . . . . ;S; ; ; _ _ _ _ _ _ ;S; ; ; ; ; ; ; ; ; ; ; ; ; ;T;T;T;T;T;T. .T. . . ^ ^ ^ 
^ ^ ^ ^ ^ ^ ^ ^ ^ ; ;T; ; ;T;T; ;T; . .T.T. . . . . . ; ; ; _ _ _ _ _ _ _ _ ; ; ; ; ; ; ;T; ; ; ; ; ; ; ;T;T;T;T;T. . . . . . ^ 
^ ^ ^ ^ ^ ^ ^ ^ ^ ^ ^ ;T; ; ;T; ;T; ^ ^ ^ ^ ^ ^ ^ . . ; ; ; ; ^ _M_M_ _ _ _ _ ; ; ; ; ; ; ; ; ; ; ; ; ; ; ; ;T;T;T;T. . . . . ^ 
^ ^ ^ ^ ^ ^ ^ ^ ^ ^ ^ ^ ^ ^ ^ ^ ^ ^ ^ ^ ^ ^ ^ ^ ^ ^ ^ ^M^ ^ ^M^ ^ ^ ^ ^M^ ^ ^ ^ ^ ^ ^ ^ ^ ^ ^ ^ ^ ^ ^ ^ ^ ^ ^ ^ ^ ^ ^ ^ ^ ^ ^ ^ 
